accounting	finance
airport	transport
amusement_park	amusement
aquarium	amusement
art_gallery	amusement
atm	finance
bakery	food
bank	finance
bar	amusement
beauty_salon	health_and_wellness
bicycle_store	shopping
book_store	shopping
bowling_alley	amusement
bus_station	transport
cafe	food
campground	recreation
car_dealer	shopping
car_rental	service
car_repair	service
car_wash	service
casino	amusement
cemetery	government
church	place_of_worship
city_hall	government
clothing_store	shopping
convenience_store	shopping
courthouse	government
dentist	health_and_wellness
department_store	shopping
doctor	health_and_wellness
electrician	service
electronics_store	shopping
embassy	government
establishment	establishment
finance	finance
fire_station	government
florist	shopping
food	food
funeral_home	service
furniture_store	shopping
gas_station	service
general_contractor	service
grocery_or_supermarket	shopping
gym	health_and_wellness
hair_care	shopping
hardware_store	shopping
hdb	accommodation
health	health_and_wellness
hindu_temple	place_of_worship
home_goods_store	shopping
hospital	amusement
insurance_agency	service
jewelry_store	shopping
laundry	service
lawyer	service
library	education
liquor_store	shopping
local_government_office	government
locksmith	service
lodging	accommodation
meal_delivery	food
meal_takeaway	food
mosque	place_of_worship
movie_rental	amusement
movie_theater	amusement
moving_company	service
museum	amusement
night_club	amusement
painter	service
park	recreation
parking	transport
pet_store	shopping
pharmacy	health_and_wellness
physiotherapist	health_and_wellness
place_of_worship	place_of_worship
plumber	service
police	government
post_office	service
real_estate_agency	service
restaurant	food
roofing_contractor	service
rv_park	recreation
school	education
shoe_store	shopping
shopping_mall	shopping
spa	health_and_wellness
stadium	amusement
storage	service
store	shopping
subway_station	transport
synagogue	place_of_worship
taxi_stand	transport
train_station	transport
travel_agency	service
university	education
veterinary_care	health_and_wellness
zoo	recreation